{
    "黄": "黃",
    "经": "經",
    "络": "絡",
    "气": "氣",
    "内": "內",
    "脉": "脈",
    "体": "體",
    "术": "術",
    "学": "學",
    "书": "書",
    "国": "國",
    "脑": "腦",
    "发": "發",
    "构": "構",
    "经": "經",
    "当": "當",
    "历": "歷",
    "风": "風",
    "气": "氣",
    "关": "關",
    "论": "論",
    "动": "動",
    "观": "觀",
    "杂": "雜",
    "习": "習",
    "广": "廣",
    "众": "眾",
    "类": "類",
    "众": "眾",
    "显": "顯",
    "论": "論",
    "测": "測",
    "验": "驗",
    "态": "態",
    "结": "結",
    "构": "構",
    "导": "導",
    "广": "廣"
  }
  